20
3 2 3 4 2 3 4 8 9 2 2 8 7 2 8 2 2 2 2 2 
3 a 0 + 0 + 0 0 0 0 0 0 0 0 2 0 0 0 0 2 
2 0 0 + 0 + 0 0 0 0 0 0 0 0 6 0 0 0 0 2 
4 0 0 + 0 + 0 0 0 0 0 0 0 0 5 0 0 0 0 2 
4 0 0 + 0 + 0 0 0 0 0 0 0 0 4 0 0 0 0 2 
5 0 0 + 0 + 0 0 0 0 0 0 0 0 2 0 0 0 0 2 
6 0 0 0 0 + + 0 0 + 0 0 9 0 3 0 0 0 0 2 
7 a 2 2 b b 0 0 0 0 0 0 2 a 2 0 0 0 0 2 
4 2 0 0 0 0 0 c 0 0 0 0 a 0 2 0 0 0 0 2 
3 5 3 4 2 5 2 c 0 0 0 0 0 9 3 0 0 0 0 2 
2 0 0 0 0 0 0 0 0 0 0 0 0 0 0 0 0 0 0 2 
2 0 0 0 0 0 0 0 0 0 0 0 0 0 0 0 0 0 0 2 
2 0 0 0 0 0 0 0 b 0 2 2 2 0 0 0 2 0 0 2 
2 0 0 0 0 0 0 0 0 0 0 0 0 0 0 0 0 0 0 2 
2 0 0 0 0 0 0 0 0 0 0 0 0 0 0 0 0 0 a 2 
2 2 2 2 2 2 2 5 6 8 6 9 1 2 4 2 2 2 2 2