20
1 2 3 4 5 6 7 8 9 1 1 1 1 1 1 1 1 1 1 1 
1 a 0 0 0 0 0 0 0 0 0 0 0 0 1 a b c a 1 
1 0 0 0 0 0 0 0 0 0 0 0 0 0 1 0 0 0 0 1 
1 0 0 0 0 0 0 0 0 0 0 0 0 0 1 0 0 0 0 1 
1 0 0 0 0 0 0 0 0 0 0 0 0 0 1 0 0 0 0 1 
1 0 0 0 0 0 0 0 0 0 0 0 0 0 1 0 0 0 0 1 
1 0 0 0 0 0 0 0 0 0 0 0 0 0 1 0 0 0 0 1 
1 a 1 1 b b 0 0 0 0 0 0 1 a 1 0 0 0 0 1 
1 1 0 0 0 0 0 c 0 0 0 0 a a 1 0 0 0 0 1 
1 1 1 1 1 1 1 c 0 0 0 0 0 1 1 0 0 0 0 1 
1 0 0 0 0 0 0 0 0 0 0 0 0 0 0 0 0 0 0 1 
1 0 0 0 0 0 0 0 0 0 0 0 0 0 0 0 0 0 0 1 
1 0 0 0 0 0 0 0 b 0 1 1 1 0 0 0 1 0 0 1 
1 0 0 0 0 0 0 0 0 0 0 0 0 0 0 0 0 0 0 1 
1 0 0 0 0 0 0 0 0 0 0 0 0 0 0 0 0 0 a 1 
1 1 1 1 1 1 1 1 1 1 1 1 1 1 1 1 1 1 1 1